GRUPPO
DataBase Italia

DATA
30/04/2023

POST
Il personaggio funzionale che ora interpreta Bergoglio, Ã¨ diventato molto attivo in questo periodo arrivando addirittura a contrapporsi alle politiche abortive e di imposizione del gender fluid.

COMMENTI
SenderA	Deo grazias
SenderB	Personaggio funzionale che cosa significa? Intende un sosia?.
SenderC	Un mascherato
SenderD	Il nuovo papacchio ha cambiato idea  prima di tirare le cuoia a breve ğŸ˜‚ğŸ˜‚ğŸ˜ğŸ˜
SenderE	Ãˆ proprio vero che â€œmorto un papa se ne fa un altroâ€œ ğŸ¤£
SenderF	@SenderE Che sia di silicone poco importağŸ˜‚ğŸ˜‚
SenderG	Forse annunceranno la sua dipartita dopo le GMG...dovremo aspettare la fine dell'estate...ğŸ˜…
SenderE	@SenderF Anzi meglio se Ã¨ un papa che viene dalla Silicon Valley ğŸ¤£
SenderH	Anche io voglio un clone fatto cosÃ¬ bene, lo mando al lavoro al mio posto!!ğŸ˜„ğŸ˜„ğŸ˜
SenderI	Felice domenica a tutti ğŸ˜˜ğŸ¤©ğŸŒ·
SenderL	Buona giornata amici
SenderM	Infatti strano questo cambio di rotta â€¦ forse che abbiano giÃ  vinto gli altri ?
SenderN	Io clonerei mettendo SenderBG  al posto di Mattarella, sarebbe lo stato piÃ¹ ricco ed onesto del mondo, dove vivi per aiutare gli altri e per mettere la tranquillitÃ  mentale al posto della paura mediatica, Luca Ã© una potenza, grazie Luca sei il numero uno al ğŸ’¯ %
SenderO	L' ho sentito e non riuscivo a credere alle mie orecchie. @SenderH Anche io !!!! Comunque , mÃ² pure il Papa che si riposiziona e dalla parte giusta, Ã¨ pazzesco.
SenderP	"Colonizzazione ideologica"...molto interessanteğŸ¤” diversi sono i pensieri che ho riguardo questa "mossa" sulla scacchiera degli eventi in atto...staremo vigili ad osservareğŸ§
SenderQ	@SenderF Sembra sia un attore veroğŸ˜
SenderR	Sull'aborto non saprei ma sul gender aveva in passato giÃ  usato il termine "colonizzazione ideologica"
SenderS	[IMAGE] Grazie SenderBGğŸ¤—ğŸ’œ, grazieğŸ™ğŸ»
SenderT	Cos'Ã¨, gli Ã¨ forse apparso GesÃ¹, come apparve a Paolo di Tarso sulla via di Damasco, e si Ã¨ redento? Ho i miei dubbi, penso che stia recitando una parte.
SenderU	@SenderR Si, lo ha usato ancora
SenderV	Ciccio il pampero, dai mille voltiğŸ˜‰ğŸ¤£ğŸ˜‚
SenderZ	Forse stava perdendo followers allora fa un poâ€™ di marketing! Oppure non Ã¨ quello che sembra!ğŸ˜
SenderAA	Dopo lo strano ricovero pre pasquale Ã¨ un altro....
SenderAB	tutta fuffa
SenderAC	INCREDIBILE
SenderAD	In effetti l'originale non avrebbe mai fatto simili affermazioni: sarebbe stato sicuramente a favore della "colonizzazione ideologica"! ğŸ˜‰ğŸ˜‚
SenderAE	Un altro si aggiunge alla categoria del grande risveglio? Allora, avanti un altro..... ğŸ˜
SenderAF	Vediamo adesso quanto calcherÃ   la mano su questi argomenti, per ora buona la prima...
SenderAG	Sarebbe bello assistere una volta per tutte alla fine di questa commedia. Siamo ragionevolmente stanchi.
SenderAH	SenderBG si vede che sei una persona BUONA. Ti mando tanta luce e spero un giorno di conoscerti di persona ğŸ™ğŸ»
SenderAI	C'Ã¨ dietro una manina magica, i Cappelli Bianchi sono al comando ğŸ’ªğŸ’ªğŸ’ªğŸ¤£ğŸ¤£
SenderAL	Grazie SenderBG sempre presente... ğŸ’– ğŸ’– ğŸ’– LUCE e AMORE... ğŸ’–
SenderAM	@SenderD Ãˆ giÃ  ufficiosamente morto
SenderD	@SenderAM Assolutamente si...gia' dal 2020 ma i normies non lo hanno ancora capito ğŸ˜‚ğŸ˜‚ğŸ˜ğŸ˜
SenderAN	Chi interpreta Bergoglio ne deduco! Quindi morto ma non dicono nulla!  Poi un cambiamento a 360Â°ğŸ˜²
SenderAO	@SenderAA Letteralmente un altro
SenderAP	Merdoglio dice una cosa e fa la opposto
SenderAQ	No comment
SenderAR	Un bel dietrofront
SenderAS	[IMAGE]
SenderAU	@SenderD Pensi dalla sera dello sparo e dell'elicottero che parti' da sopra San Pietro. Io lÃ¬ pensai ad una sostituzione se non proprio ad una morte
SenderAV	Si si anch'io una clone e la mando a letto con mio marito ğŸ˜‚ğŸ˜‚ğŸ˜‚ğŸ˜‚
SenderAZ	Un colpo al cerchio e l'altro alla botte
SenderBA	ğŸ’¥ La nuova versione del clone dice l'esatto contrario di quello che predicava l'altra versione alcuni mesi fa? Ottimo! Il nuovo programma funziona bene ğŸ’ªğŸ»ğŸ’ªğŸ»ğŸ’¥ğŸ’¥
SenderBB	[IMAGE]
SenderBC	Sto seguendo sulla Rai i commenti riguardo la sua visita. Hanno sparato un sacco di minchiate, ma nessun riferimento a questi due temi. Hanno fatto finta di nulla.
SenderBD	Se dovessero rimpiazzare imbroglio con matteo maria zuppi, gli toccherÃ  ricominciare tutto da capo ğŸ˜…
SenderBE	Sta sotto minaccia?
SenderBF	Vedendolo in salute e con idee nuove ho pensato che non sia lâ€™originale.
SenderBG	@SenderN Troppo gentile Valerio ğŸ¥°ğŸ¥°ğŸ™ğŸ™
SenderBH	Bellissima inversione a U dal oltretomba
SenderBI	Anche se non Ã¨ il Papa almeno si comporta da tale. Matteo Zuppi quando l'ho conosciuto sembrava molto umile, mi era anche piaciuto il suo modo di porsi. Poi ho visto chi era veramente in perfetta linea con il PD e mi ha fatto shifo
SenderBL	Imbroglio fulminato sulla via di Damasco ğŸ¤£ğŸ¤£ğŸ¤£ğŸ¤£
SenderF	@SenderQ Avrei un paio di nomi a riguardo......ma lasciamo la sorpresa alla fine dello show ğŸ˜‚ğŸ˜‚ğŸ˜‚ğŸ˜‚ğŸ˜‚ @SenderE Comunque ulitmamente non sta bene, sembra proprio un altro ğŸ˜‚ğŸ˜‚ğŸ˜‚ğŸ˜‚ğŸ˜‚
SenderBM	Ãˆ tutto surreale, Clone o non Clone. Stiamo vivendo di ipotesi, supposizioni e tutto sembra fatto apposta per confondere ...o sbaglio?
SenderBN	E lo fa nel paese piÃ¹ conservatore dâ€™Europaâ€¦ Pensavo primo momento a ipocrisia ma giustamente come dite sembra un cambio di tendenza nel copioneâ€¦ Vediamo gli sviluppi!
SenderBO	Discorso di convenienza per il posto dove si trovava. Buongiorno e buon primo maggio!â˜•ï¸ğŸ°ğŸ’ª
SenderBP	@SenderAG Lei ha perfettamente ragione...io comincio a non poterne piÃ¹ di nessuno...saluti