GRUPPO
EDOARDO DINI IL CLAN DELL'ANTIVIRUS

DATA
12/07/2023

POST
E dopo miss Olanda trans, ecco a voi miss culetto dâ€™oro 

ğŸ‘‰ğŸ¤®ğŸ‘ˆ

La nuova America. O la accetti o sei fasssssista 

ğŸŸ¡ SEGUICI SU CONSENSO DISINFORMATO (https://t.me/consenso_disinformato)

COMMENTI
SenderA	Che schifo !!!
SenderB	ğŸ¤®ğŸ¤®ğŸ¤®ğŸ¤®
SenderC	Mecoioni
SenderD	Queato dovewbbe essere il nuovo mondo, che vadano affanculo tuttiğŸ¤®
SenderE	Brutto da uomo e brutta da donna
SenderF	Che obbrobrio ğŸ¤®
SenderG	ğŸ˜‚ğŸ˜‚ğŸ˜‚ğŸ˜‚ğŸ˜‚ğŸ˜‚ğŸ˜‚ğŸ˜‚ğŸ˜‚ğŸ˜‚ğŸ˜‚ğŸ˜‚ğŸ˜‚ğŸ˜‚ğŸ˜‚ğŸ˜‚ğŸ˜‚ğŸ˜‚ğŸ˜‚ğŸ˜‚ğŸ˜‚ğŸ˜‚ğŸ˜‚ğŸ˜‚ğŸ˜‚ğŸ˜‚ğŸ˜‚ğŸ˜‚ğŸ˜‚ğŸ˜‚ğŸ˜‚ğŸ˜‚ğŸ˜‚ğŸ˜‚ğŸ˜‚ğŸ˜‚ğŸ˜‚ğŸ˜‚ğŸ˜‚
SenderH	ğŸ¤®ğŸ¤®ğŸ¤®ğŸ¤®ğŸ¤®ğŸ¤®ğŸ¤®
SenderI	Miss pisellino depilato
SenderL	Se cade in acqua  non affoga.....tra labbra e chiappe sta a galla tranquillamente ğŸ˜‚ğŸ˜‚ğŸ˜‚ğŸ˜‚ğŸ˜‚ che ribrezzoğŸ¤®ğŸ¤®ğŸ¤®
SenderM	Minchia, non si po' taliari!!!!
SenderN	...allora: io fasssssissssta!ğŸ˜Œ
SenderO	Dategli foooo ğŸ”¥ğŸ”¥ğŸ”¥ğŸ”¥ğŸ”¥ sudiciumi......
SenderP	Ma c'e'gente che va a vedere quindi..............
SenderQ	Cazzo e da vomito
SenderR	Mammamiacheffrocio!!ğŸ¤® Questo non si puÃ² avvicinare al caminetto che fonde ğŸ˜‚ğŸ˜‚ğŸ˜‚ğŸ˜‚ğŸ˜‚ğŸ˜‚
SenderS	Che Schifo
SenderT	Blaaaaaaahhhhh
SenderU	Che obrobio  ripugnante ne carne ne pesce ,immondizia dentro e fuori...
SenderV	@SenderP [AUDIO]
SenderZ	Peccato, ha terre sconfinate e paesaggi spettacolari ma.......
SenderAA	Orribile
SenderAB	OoosssignurrrğŸ˜±
SenderAC	Abominevole ğŸ˜–ğŸ˜–ğŸ˜–
SenderAD	Chi mi sa spiegare xke' tutto questo schifo lo pubblicizzano?