GRUPPO
L'AntiDiplomatico

DATA
05/04/2023

POST
â€œUn pastore americano transgender paragona lo stragista di Nashville a 
GesÃ¹"

Fox News

https://www.foxnews.com/video/6323946239112

---------------------
ğŸŸ¥ AGGIRA LA CENSURA. SEGUI L'ANTIDIPLOMATICO:
https://t.me/lantidiplomatico

COMMENTI
SenderA	[LINK]
SenderB	Che vomito schifoso ğŸ¤®ğŸ¤®ğŸ¤®ğŸ¤®ğŸ¤®
SenderC	Devono bruciare all'inferno subito
SenderD	#AridateceTorquemada
SenderE	Scarafaggio maledetto
SenderF	Anglosassoni  da vaporizzare
SenderG	L'Ammerdica
SenderH	Frocione schifoso pervertito pedofilo
SenderI	Lâ€™America Ã¨ il ventre del male! Da lÃ¬ partono tutte le nefandezze del mondo!
SenderL	Se non ci fossero piÃ¹ paesi a cui dichiarare guerra gli USA dichiarerebbero guerra a se stessi.
SenderM	Ma la gente entra lo stesso in quella "chiesa"? ğŸ˜¡
SenderN	Il pastore lo manderei a badare le pecore, quello sarebbe il suo posto
SenderO	Deve essere qualche setta strana
SenderP	Gli yankee hanno un sacco di problemi mentali ecco perchÃ© Ã¨ la prima nazione al mondo per uso di psicofarmaci e droghe
SenderQ	[VIDEO]
SenderR	...ma non ci potete mettere i sottotitoli?
SenderS	Un abominio
SenderT	Il punto piÃº basso della civiltÃ 
SenderU	Non ci sono parole per definirlo/a
SenderV	Beh, finchÃ© si Agazzano tra americani, va benissimo ğŸ¤™
SenderZ	Non si riprendono piÃ¹ da sta catastrofe. Stanno fori
SenderAA	Questa Ã¨ una bestemmia. I protestanti sono totalmente alla deriva e Bergoglio vuole portare la chiesa in questa deriva. E tutto ciÃ², essendo l'opposto della parola del vangelo, Ã¨ satanico.
SenderAB	Dobbiamo liberarci dagli americani; da ogni contesto civile. Il re Ã¨ nudo.
SenderAC	@DELSENDER Purtroppo non Ã© cosÃ­: nelle universitÃ¡ i problemi sono solo LGBT, gender, woke e clima. Tutti odiano i novax. La guerra Ã© colpa di Putin e Trump.
SenderAD	Quanto aveva ragione Khomeini
SenderAE	Riaprire i manicomi
SenderAF	Ma negli USA ci sono rimaste anche persone normali o sono tutti aborti del cazzo?
SenderAG	@SenderL Nordisti e Sudisti...lo han giÃ  fatto...ma non dispero, potrebbero pure rifarlo, piÃ¹ di prima, meglio di prima
SenderAH	Nn lo prendo neanche minimamente in considerazione
SenderAI	@SenderAC Ãˆ vero, non capisco perÃ² la correlazione con la guerra ( Ã¨ una operazione speciale perchÃ© se fosse una guerra Putin ci avrebbe giÃ  annientati) e con Putin e Trump,dei quali non si puÃ² certo dire che appoggino queste che sono facezie che sono sempre esistite e adesso vogliono trasformare in in problematiche monumentali che nascondono l'incapacitÃ  di affrontare i problemi reali e grandi che hanno le persone...
SenderAL	Uno schifo che sono l'America
SenderAH	@SenderAE E date la chiave a me so cosa farne
SenderAM	Ormai bestemmiano apertamente
SenderAN	@SenderAB ğŸ‘ğŸ‘ğŸ‘ğŸ‘ğŸ‘
SenderAO	Da maiali eretici che vi aspettate!
SenderAP	Psicopatici
SenderAQ	Non poteva parlar male di un "SOCIO" .....certo che il paragone mi sembra un tantino esagerato  !
SenderAR	Che deriva umana!
SenderAS	Pastore?
SenderAU	ormai Ã¨ gara a chi la spara piÃ¹ grossa
SenderAV	I valori occidentali per cui difendiamo l'Ucraina e di cui sentivo parlare pure alla radio vaticana lunedÃ¬ pomeriggio...e non sto scherzando
SenderAZ	I demoni sono tra di noi. GesÃ¹ Cristo abbi pietÃ  di noi !
SenderBA	Satanisti capovolgo la croce come questi ibridi capovolgono la veritÃ .
SenderBB	Questo Ã¨ lo schifoso progressismo made USA
SenderBC	E il cartello Fox news ????
SenderBD	NON PRAEVALEBUNTğŸ™ğŸ»â¤ï¸
SenderBE	Si, in effetti un pastore di ğŸ’©
SenderBF	Amazati cretino
SenderBG	quindi sarebbe una pastrice ?
SenderBH	Che schifo....lo faranno papa....
SenderBI	@SenderAA Cosa c'entra la chiesa cattolica? Le risulta che ci siano sacerdoti trans gender?
SenderBL	Sostanzialmente dice che come i sommi sacerdoti cercavano un pretesto per uccidere GesÃ¹, in questo caso ( quelli che sono contrari ai trans) cercano, in questa strage un pretesto per dare addosso ai trans anzichÃ© proibire le armi. Non Ã¨ esattamente un paragone fra GesÃ¹ e il trans, ma certamente  un discorso parecchio forzato e non pertinente, dato che GesÃ¹ era innocente e non aveva ucciso nessuno.  Quanto seguito abbia poi questo pastore, seppur ne ha, non Ã¨ chiaro.
SenderBM	@SenderBL Non l'ho ascoltato ma se fosse come dici tu, il.titolo traduttivo in Italiano sarebbe piuttosto fuorviante (o infelice).
SenderAA	@SenderBI Legga bene! Per prima cosa ho detto che paragonare l'omicida di Nashville a GesÃ¹ Ã¨ una bestemmia. GesÃ¹ non fece nessun atto delittuoso! Seconda cosa la deriva anticristiana sta' colpendo, non solo i protestanti, ma anche la falsa chiesa bergogliana.
SenderBI	@SenderAA Falsa chiesa 'sto cazzo. Smettetela di scrivere minchiate.
SenderAA	@SenderBI Mancava solo un fan di Bergoglio/ Lorefice. Le apostasie sono quelle di Bergoglio che porta Pachamama in Vaticano, che minimizza la figura della Madonna, rivaluta persino Giuda, definisce tutte le religioni uguali, approva la comunione ai divorziati/risposati, cambia le parole del Padre Nostro che vengono direttamente da GesÃ¹, benedice che lo coppie gay . Un totale capovolgimento del Vangelo. Lorefice, quello con i parametri sacri che scorazza con la bicicletta dentro la chiesa ğŸ™„ğŸ™„ğŸ™„ PS:se certe teorie sono propugnate da chi non Ã¨ cattolico Ã¨ lecito. Non ammissibile, a livello religioso, che lo facciano chi si professa portatore della parola di Cristo Questa sarebbe la vera Chiesa? [LINK] PS:questa sarebbe una cazzata?
SenderBI	@SenderAA Ecco, ti mancava? Ora ce l'hai. Quando la smetterete di scrivere gigantesche cazzate e fare il gioco del nemico, fatecelo sapere.
SenderAA	Non sono cazzate avete solo le feste di prosciutto negli occhi! Questo video Ã¨ falso? Tutto normale ? Quindi un Papa puÃ² benedire, non piÃ¹ una statuetta di Lourdes ma perchÃ© no anche una statua di Buddha...
SenderBN	la vera nuova Babilonia. e finira come le prima.
SenderBO	Un pastore transgender fa giÃ  ridere da se. ğŸ˜‚ğŸ¤£ğŸ˜‚ğŸ¤®
SenderBP	Sono falsi pastori infiltrati come in tutte le organizzazioni
SenderBQ	Servi di satana
SenderBR	Un pazzo vestito da prete...
SenderBS	Blasfemo e satanico! Il diavolo vestito a prete!
SenderBT	Ma negli USA ci sono solo trasgender? Uno normale si trova? Forse no.
SenderBU	Non so se sia peggio questa sacerdotessa pagana o il satanista bergoglio che bestemmia in chiesa.....
SenderBV	Spaventoso! Com'Ã¨ possibile che qualcuno ascolti queste schifezze.
SenderBZ	[LINK]