GRUPPO
Ugo Fuoco 🔥 Stop Dittatura

DATA
19/12/2022

POST
🔴💣PEDOFILIA, BIDEN PROSEGUE NELLA SUA AGENDA DI SDOGANAMENTO?
🔥ECLATANTE È LA NOTIZIA DELL'INVITO ALLA CASA BIANCA DA PARTE DI JOE BIDEN ALLA DRAG QUEEN MARTI G CUMMINGS CHE AVEVA TWITTATO 'I BAMBINI SERVONO A CANTARE E SUCCHIARE IL C....'
✴️L'IMPRESSIONE È CHE L'AGENDA GENDER VENGA UTILIZZATA DALLE ALTE SFERE PER SDOGANARE LA PEDOFILIA, LARGAMENTE DIFFUSA FRA LE ÉLITE DI POTERE.
🏴‍☠️SI TRATTA DI ARGOMENTI DIFFICILI MA È INDISPENSABILE CHE CIASCUNO DI NOI SI ADOPERI PER PARLARNE. QUESTO È IL SOLO MODO PER FAR EMERGERE LA VERITÀ E SALVAGUARDARE I BAMBINI.
⛔️A SEGUITO IMPORTANTI APPROFONDIMENTI SU QUESTO TEMA FONDAMENTALE, VISIONATELI ED AIUTATECI A DIFFONDERE. 

COMMENTI
SenderA	Fanculo si puo dire? Senza nulla a pretendere... Ddl zan...🖕...e tutto il PD ...e famiglia.
SenderB	🤮🤮🤮💩💩💩💩 
SenderC	Mi viene il vomito, non riesco più a vedere un film statunitense o seguire un programma rai
SenderD	Pedofili satanisti accettati benevolmente dagli Usa ❗️
SenderE	@SenderC TV regalata ( e canone cancellato ) diversi mesi fa .... qualcuno mi ha detto : ma come fate senza ??? 😳😳😳🤣
SenderF	@SenderE Lo hanno detto anche a me. Io sinceramente ci guardo solo film, documentari e cose che mi interessano.
SenderG	Grazie Ugo Fuoco per questa controinformazione
SenderA	Ugo, come stai? Un grande saluto. 👍👍👍
SenderH	Bruciateli vivi. 😡
SenderI	Chi è avvezzo a seguire canali come questo, per dovere, a mio avviso, nell'informarsi riguardo ciò che accade nel mondo, conosce questi argomenti da voltastomaco. Il problema, enorme, almeno per quel che mi riguarda, sta nel far capire nel quotidiano ai conoscenti quanto questi siano reali e non 'semplici' pensieri da complottista o paranoico. Sembra che molti vivano in un'altra galassia. Complimenti Ugo per il lavoro che fai. Un abbraccio.
SenderL	Che schifo 😡 i bambini non si toccano  maledetti depravati💩💩💩💩
SenderM	Schifosi tutti e anche sta travestita demone ,che bruci all infinito all inferno
SenderN	Di che vogliamo parlare?....fanno schifo.
SenderO	Morissero tutti sti schifosi 🤬🤬🤬⚰️⚰️⚰️⚰️⚰️⚰️⚰️⚰️
SenderP	In che senso sangue diverso, puoi specificare? Grazie Maledetti, i bambini non si toccano!!!
SenderQ	Maledetti skifosi
SenderR	Grazie Ugo per il tuo lavoro!! Da noi in Russia famiglia è uomo + donna!! Dobbiamo difendere i valori della famiglia!!
SenderS	Credo che  questi pedofili abbiano trovato un modo per avvicinare i bambini senza allarmare i genitori, se no non avrebbe  senso che  un uomo si  travesta da donna, perché  non e un gay  ma un uomo normale!
SenderT	@SenderE Sei un grande 👏👏👏👏vorrei poterlo fare anch'io ma ho un'anziana di 90 anni  in casa attaccata alla TV tutto il giorno, non ha altro da fare ....
SenderU	Avatar 2 da aggiungere ai motivi di "morte e malori improvvisi senza nessuna correlazione"😂😂😂  [LINK]
SenderV	Meritano una sola cosa 🪓🪓🪓🪓🪓🪓🪓🪓🪓🪓🪓🪓🪓🪓
SenderZ	@SenderI semplicemente è un mondo di 💩
SenderAA	Ripristinare pena di morte per i crimini contro i minorenni.
SenderAB	Bidè è un rincoglionito, bisogna vedere da chi è manipolato, fare un bel great reset
SenderAC	Bisogna dare atto a Rimbambidon che non ha pregiudizi di alcun tipo. A lui va bene qualsiasi età, meglio se sotto i 10,  qualsiasi razza, qualsiasi religione, qualsiasi, tendenza. È un essere aperto a tutto
SenderAD	Tocca capire chi ha davvero invitato sto esperimento, visto che biden a malapena si ricorda di non essere in una casa di riposo
SenderAE	Maledetti criminali 🤬🤬💩💩🤮🤮
SenderAF	Io condivido subito spero che un giorno tutti i pedofili siano castrati
SenderAG	Non c'è punizione abbastanza severa per questi malati pervertiti pedofili e neanche per i vampiri succhiasangue di neonati... brutti esseri immondi
SenderAH	… eh niente… hanno solo i bambini in testa.. deviati schifosi… @SenderI Idem… nel mio caso è come se il cervello gli diventi impermeabile quando ascoltano qualcosa non conforme…
SenderAI	In una parola decapitazione x questi esseri demoniaci
SenderAL	filos come desinenza finale di una parola dal greco significa AMANTE DI. Quindi Pedofilo è un termine perfetto. AMANTE DI BAMBINI. Per me hai solo scritto una puttanata senza alcuna contezza etimologica di quel che stavi dicendo. Di certo non hai frequentato il liceo classico.
SenderAM	Non ho parole x definire  questo grande scandalo.
SenderAN	E dargli Fuoco... Ugo ?
SenderAO	Sembra che le immagini di Cluney e Obama in barca siano raccapriccianti