GRUPPO
Ugo Fuoco ğŸ”¥ Stop Dittatura

DATA
22/06/2023

POST
ğŸ”´ğŸ’£UTERO TRAPIANTATO IN MASCHI BIOLOGICI, LA CLINTON FOUNDATION FINANZIA GLI STUDI.

ğŸ”¥VelocitÃ  supersonica, Ã¨ quella a cui stanno andando per la dissoluzione di ogni buonsenso ed per porre in essere la piÃ¹ miserabile mercificazione dei corpi mai realizzata nella storia e che, come di consueto, porterÃ  le tasche dei soliti noti a riempirsi di miliardi perchÃ©, si, questo settore diventerÃ  anche un enorme business.

ğŸ”ºï¸Nel prossimo futuro le donatrici di organi concederanno il proprio utero anche agli uomini che vorranno impiantarselo per poter rimanere incinti.

âš¡ï¸Tutto vero, vi linko a seguito un paio di fonti fra cui quella di Pubmed. 

ğŸ”ºï¸Fonte 1 (https://www.ncbi.nlm.nih.gov/pmc/articles/PMC6492192/)
ğŸ”ºï¸Fonte 2 (https://rubenluengas.com/2023/04/la-fundacion-clinton-financio-estudios-para-trasplantar-uteros-a-hombres-biologicos/)

â–ªï¸Non so cosa ne pensiate, ma esorto sempre tutti al confronto, specie quando si tratta di argomenti di tale tenore. Le vostre idee sono fondamentali per tutta la comunitÃ  e vengono lette da migliaia di persone, rendetele pubbliche.

COMMENTI
SenderA	La gramigna va estirpata alla radice.
SenderB	Contenti  loroğŸ˜‚ğŸ˜‚
SenderC	Poi uscirÃ  qlk str......zo ğŸ˜‚ altre vie nn c sono
SenderD	Che schifo ğŸ¤® ğŸ’©ğŸ’©ğŸ’©ğŸ’©
SenderE	Trapiantarli in donne sterili Ã¨ tanto difficile?
SenderF	Quando si va contro la natura, la natura si difende. E, come sempre, vince lei...
SenderG	Ormai credo che sia inutile spiegare che siamo alla follia vista la grande quantitÃ  di folli che vivono su questa terra che accettano e applaudono a queste schifezze contro natura
SenderH	Frankenstein al confronto Ã¨ uno studentello.... Un mondo marcio fino al midollo.
SenderI	Orrendo
SenderL	La natura si ribellerÃ  a tutti gli esperimenti, bestie di Satana
SenderM	A che cazzo serve questa porcheria? Non volevano depopolare? Ora invece cercano nuovi modi per far concepire anche i maschi? A giÃ  , ma devono devastare le menti dei giovani...ğŸ¤®
SenderN	Schifosi demoni
SenderO	Hahahaha ğŸ˜‚ non piÃ¹ solo froci, ma vogliono essere anche mamme ğŸ˜‚ğŸ˜‚ğŸ˜‚
SenderP	Puoi anche imbottire di ormoni femminili un uomo ma questo non sarÃ  mai una donna. Ãˆ piÃ¹ facile creare una incubatrice esterna che far concepire e portare avanti la gravidanza in un uomo.  Ãˆ da folli squilibrati e indemoniati solo pensare a tutto ciÃ².
SenderQ	Non mi stupisce la "sperimentazione" di tale abominio ma la velocitÃ  delle deformazioni mentali di questi "dis-umani"!
SenderR	Adorano un dio con bigolo e tette, Bafometto, tutto quello che fanno parte da lÃ¬, e corrompono i bambini nelle scuole da sacrificare al loro dio.
SenderS	Questi esseri abominevoli si sentono Dio in terra,ma presto tutto finirÃ  ğŸ˜¡
SenderT	Mi aspettavo di tutto -quasi - nella vita , ma mai di assistere a tale schifo di merda
SenderU	Da esseri malvagi come la Clinton ci si puÃ² aspettare questo e molto altro...
SenderV	Ma vai a fare in culo psicopatica pedofila satanista
SenderZ	Questa stronza malvaggia chiamata hillari Clinton e una pazza psicopatica da rinchiudere in manicomio ben legata a letto .....
SenderAA	Schifezza immonda!
SenderAB	Se riuscissero.... Poveri quei bambini!!!! Quale futuro avranno?..... Mah!!!!!
SenderAC	Fossi una donna inizierei a preoccuparmi, se non avranno neanche l'esclusiva di poter donare la vita il sistema fara' di tutto per eliminarle...tanto per tutto il resto ci saranno gli uomini che saranno di certo molto piu' produttivi.
SenderAD	Come se un corpo che porta avanti una gravidanza possa essere limitato al solo avere un utero.
SenderAE	...mancano cecchini.....i manicomi ormai sono inservibili...
SenderAF	Ma non sarebbe ora che la Clinton passasse a miglior vita?
SenderAG	Sono streghe e stregoni
SenderAH	Ã‰ un essere del male, un individuo satanico.
SenderAI	Sbaglio, o questi "esperimenti che facevano i nazisti nei campi di concentramento sono stati condannati DAK tribunale di Norimberga? Ora invece va bene? ğŸ˜ ğŸ˜¡
SenderAL	Penso che piÃ¹ di cosÃ¬ non si possa gio
SenderAM	La Clinton andrebbe bruciata insieme a quella puttana della figlia
SenderAN	Arimane alla riscossa....distruggono il senso d identitÃ .....
SenderAO	@SenderP Lâ€™incubatrice esterna giÃ  esiste, vi mettono dentro un ovulo fecondato e i futuri genitori possono andare a vedere periodicamente la crescita dellâ€™embrione.  Avremmo una popolazione senzâ€™anima!
SenderAP	Mi sembra tanto complesso come organo da poter trapiantare con un buon risultato....ğŸ¤”
SenderAQ	DA VOMITO ğŸ‘¹ğŸ‘¹ğŸ‘¹ğŸ‘¹
SenderAR	Siamo alla follia ! Da questi criminali assassini , aspettiamoci di tutto e di piÃ¹ !
SenderAS	@SenderAP Ho inserito la fonte dal Pubmed, Ã¨ stato giÃ  trapiantato decine di volte con successo e sono nati piÃ¹ di 10 bambini dall'innesto. Leggete le fonti.
SenderAU	@SenderM bravo.... l'orrore satanico Ã¨ anche questo: contraddizione continua dentro le stesse menzogne contro natura.... una corsa a rendere tutti folli coloro che vanno dietro a questa roba,... infatti i poveri ragazzi che si sottopongono a tali stravolgimenti della propria PERSONA, in gran numero poi si suicidano (come riferito da notizie recenti)ğŸ˜“  perchÃ¨ le menti sono devastate, appunto, non riconoscono piÃ¹ se stessi e il senso della propria vita
SenderAV	@Senderaf Si certamente e anche in compagnia di molti altri!
SenderAZ	Auguri, se non educhiamo i figli ci pensano loro, e li condizionano a loro piacimento. Avremo un futuro di degenerati ibridi !!!
SenderBA	Che dementi
SenderBB	Come la penso io? Troppo inverosimile... senza contare l'atrocita' dell'intervento... no Grazie
SenderBC	Illary Ã¨ un demone in terrağŸ¤®
SenderBD	A questi demoniaci fisogna darle fuoco
SenderBE	Satana perirÃ 
SenderBF	SarÃ  un grande fallimento, solo un altro modo di rubare soldi pubblici esattamente come per i sieri covid, clima, crisi economica, terrorismo, ecc. pensate seriamente che per far crescere un feto basti un contenitore uterino impiantato in un corpo? Per creare il sistema riproduttivo femminile ci sono voluti milioni di anni e questi cialtroni della scienza medica fallita, in quattro e quattrâ€™otto fanno lâ€™uomo gravido. Ma per caritÃ . Non hanno collezionato altro che fallimenti in ambito medico scientifico e la condizione di salute sempre piÃ¹ precaria delle persone ne Ã¨ testimone. Non hanno prodotto altro che veleni farmacologici e vaccinali non puntando mai sulla strada maestra della prevenzione. Questo sarÃ  un altro modo per far soffrire persone e mettere al mondo i loro mostri umani transumanizzati. Ignorateli e basta, solo cosÃ¬ scompariranno per sempre.
SenderBG	Questi sono da rinchiudere e buttare via la chiave..
SenderBH	@SenderN Clinton satanisti dichiarati. La Cesso dice che il satanismo Ã¨ una religione.
SenderBI	Che confusione sessuale ...!!! Che purtroppo si trasmetterÃ  alle generazioni future.  Non c'Ã¨ piÃ¹ etica.. il caos.. spero davvero che la natura riporti tutte le cose al proprio posto.  Esiste pesci ermafroditi che x metÃ  della loro vita sono maschi e poi diventano femmine, e fanno parte della natura.  Noi invece la forziamo artificialmente.  Dando sempre piÃ¹ la presenza di personaggi ambigui, anche nelle TV x bambini. Prima guardavo RAI yoyo e mi chiedevo se il ragazzo fosse una ragazza.  Cmq era gay.  Non ho nulla contro i gay, credo che possano essere compresi dai bambini un po piÃ¹ maturi. Se uno dei miei figli mi dice di essere gay lo accetterei, rimane sempre mio figlio. Non vanno emarginati. Ma l ostentazione nell essere gay come se fosse una moda,o il creare continuamente confusione sessuale e perversione, Ã¨ uno schifo. Poveri bimbi del futuro chissÃ  con quali mentalitÃ  deviate dovranno fare i conti...
SenderBL	Conduce Satana non Dio.Non finira finche sparira l'umanitÃ .
SenderBI	Spero non si debba arrivare a tanto... magari tocchiamo il fondo un po prima di estinguerci Ma poi questi uomini ci tengono tanto a essere gravidi e a partorire? Dei masochisti! Ho avuto 3 figli, ho preso coraggio e l istinto materno mi ha guidato,  e ho superato non senza problemi i 3 parti. Ma tante volte ho pensato che era meglio se fossi nata uomo x risparmiarmi le "rotture" femminili, tra ormoni su e giÃ¹,  mestruazioni, ginecologi e via dicendo
SenderBM	A quanto sembra nessuno ha imparato niente da Sodoma e Gomorra...probabilmente ci sarÃ  il bis...si va incontro alla distruzione di una civiltÃ  incivile...
SenderBN	Sono sconcertata
SenderBO	Si prevedono parti anali!
SenderBP	@SenderBO ğŸ¤£ğŸ¤£ Altri str..zi sulla faccia della terra!!
SenderBQ	Beh, voglio vederli alle prese con un parto naturale  perÃ²........ ğŸ˜ sennÃ², sono capaci tutti.. ğŸ˜†
SenderBR	Trapiantategli un palo nel culo.
SenderBS	@SenderAS Santoddio, ho il terrore a pensare che bambini siano potuti uscire fuori... Contronatura cosÃ¬... ğŸ˜¢
SenderBT	A mio avviso diventare genitore Ã¨ un'opportunitÃ  che la vita puÃ² regalarti, oppure per svariate cause/sesso non te la dÃ , ma diventare genitori non Ã¨ un diritto
SenderBU	Ma fatevi trapiantare il cervello che vi siete bruciato!!!
SenderBV	Pare che non ci siano piÃ¹ neuroni funzionanti
SenderBZ	ghei mammi significa la fine della vita umana sulla Terra.
SenderCA	Allucinante questa bestia di satana
SenderCB	@SenderBL No, finira' quando tornera' il Signore, nn manca tanto, siamo negli ultimi tempi, cercate la fede in Dio, solo Lui ci salvera' da questi demoni
SenderCC	Maledetti Americani di merda. Una razza da estinguere subito
SenderCD	Il problema non Ã¨ quello che studiano, il problema sono i dementi che faranno da cavie.....quello Ã¨ il problema piÃ¹ grave....
SenderCE	Sono schifatoâ€¦
SenderCF	@SenderBL E che muoia Sansone ma, con tutti i Filistei
SenderCG	ğŸ¤®ğŸ¤®ğŸ¤®ğŸ¤®ğŸ¤®ğŸ’©ğŸ’©ğŸ’©ğŸ’©ğŸ¤®
SenderCH	Ugo, io e te possiamo avere avuto le nostre divergenze su certi argomenti, ma questa volta sono assolutamente d'accordo con te. Queste battaglie le sostengo anch'io. La degenerazione SATANICA a cui sono arrivati una certa fetta di progressisti Ã¨ inaudita.
SenderCI	aberrazioni continue ğŸ˜¢
SenderCL	Questi sono squilibratiğŸ¤®ğŸ¤®
SenderCM	Ugoooooâ€¦FINALMENTEEEEEğŸ˜ƒâ€¦Biden Ã¨ appena stato messo sotto impeachment con mozione d'urgenzaaaaa!!! ğŸ’ªğŸ»ğŸ˜ƒğŸ‘ğŸ»ğŸ¥³ğŸ‰ Ãˆ importante che tu ne parli perchÃ© i telegiornali (ovviamente) non ne stanno parlando per nulla! Quando fu per Trump successe un casino a reti unificate â€¦ricordi!?
SenderAU	@SenderCM siamo sicuri ?ğŸ˜µsiamo sicuri ?ğŸ˜µ
SenderCM	Qui non posso inviare video. Ti ho appena mandato uno spezzone della Camera Bassa in privato dove Ã¨ inequivocabile
SenderAU	@SenderCM ho letto ora una precisazione sul canale di Rossella Fidanza (che Ã¨ una  anglista e traduttrice, esperta di fatti USA ...e specialmente monitora Biden, Trump e dintorni da 4 anni). Lei dice che in realtÃ  non Ã¨ stato messo in stato d'accusa, ma Ã¨ passata una MOZIONE per discutere in Commissione su una proposta di impeachment, un po' diverso ğŸ˜… ma speriamo che qualcosa si muova piÃ¹ decisamente ğŸ¤·ğŸ»â€â™€ï¸
SenderCM	@SenderAU Si SenderAUâ€¦infatti specificavo anche io fin da subito della MOZIONE Dâ€™URGENZA. So bene che ancora non Ã¨ pieno impeachmentâ€¦mi rincuorava solo questa manovra che non mi sarei mai aspettato conoscendo il livello di corruzione a tutti i livelli. Significa che qualcosa inizia a cambiare. Comunque grazie per averlo precisato anche tu ğŸ™ğŸ»
SenderAS	@SenderCM Ciao SenderCM, in realtÃ  la cosa Ã¨ controversa. Ci sono alcuni repubblicani capeggiati da Lauren Boebert (di cui in passato parlammo anche qui nel canale) che hanno voluto forzare la mano. Al momento non c'Ã¨ nulla di concreto, ne discuteranno in commissione...ma queste cose finiscono sempre in un nulla di fatto.
SenderCM	Mi â€œstupisceâ€ in particolare che se fosse stata una mozione per Trumpâ€¦behâ€¦allora stai pur certo che ne avrebbero parlato ovunque!
SenderAS	@SenderCH Abbiamo divergenze sul fatto che tu hai una devianza. I minori non devono interessarti, Ã¨ una cosa sbagliata e la devi cambiare. Tu e tutti quelli che la pensano come te. Per il resto si discute come Ã¨ lecito che si faccia fra persone. Ciascuno ha le sue idee e possono esserci dibattiti anche accesi...ma questo avviene sempre nel rispetto delle altrui idee. @SenderCM Stanno dandosi battaglia perchÃ© le elezioni si avvicinano.
SenderCN	La mente dei giovani Ã¨ giÃ  devastata, ho 3 figli e tutti non vedono problemi e sono ben disposti verso qualunque tipo di porcheria messo in piedi dall'agenda transgender. A loro va bene tutto, dicono che bisogna essere mentalmente aperti e non si rendono conto che andare contro natura Ã¨ la cosa peggiore possibile, nonostante io e mia moglie cerchiamo tutti i giorni di fargli cambiare idea. SarÃ  un mondo di m....
SenderCO	Penso che tutto ciÃ² che sia contro natura si puÃ² considerare  assolutamente aberrante e demoniaco.... L'uomo sta peccando di forte presunzione nel volersi sostituire a dio e alla natura....Frankenstein non Ã¨ nulla al contronto... Modificazioni corporali,sessuali e ora ,il dono piÃ¹ sacro e  prezioso della vita viene snaturato, sminuito...siamo alla deriva...meritiamo l'estinzione
SenderCP	Se Ã¨ vero che la natura comanda sempre allora questi abomini sono destinati ad estinguersi da soli, e non senza sofferenza
SenderCQ	Speriamo che una volta trapiantato ci sia il rigetto!che schifo di societÃ 
SenderCR	@SenderBO Non credo si arriverÃ  a questo, tra di loro Ã¨ importante che il "foro" rimanga stretto. Si provvederÃ  con il taglio cesareo, eventualmente.
SenderCS	@SenderL C'Ã¨ giÃ  stato un precedente... nel 1912 se non ricordo male...
SenderCT	Quando si dice: ZOCCOLONA*TROIONA â€¦..
SenderCU	Follia allo stato puro
SenderCV	Che criminali hanno venduto l'anima  a satana,,,ma quando moriranno questi esseri dove pensano di andare per l'eternitÃ ,,,Ã¨  su perchÃ©  anche loro moriranno,  sono folli
SenderCZ	La clinton deve farsi trapiantare una bomba a mano nel culo e poi esplodere. Sta lurida puttana satanista e assassina
SenderDA	Ritorneranno tutti nella fogna dalla quale sono usciti
SenderDB	non gli abbastava esse guerrafondaia e pedofila, mÃ² vo' esse dio, ma vattelaapijÃ nderculo e sbrigate pure e giÃ  che ce vai portace pure Cessa
SenderDC	La selezione naturale rimetterÃ  le cose al loro posto. Con nostra somma gioia !!
SenderDD	Veramente uno schifo assurdo, spero che la gente apra gli occhi
SenderDE	Poveri quei feti che cercheranno di far crescere li dentro contro natura e che avranno problemi o moriranno nella pseudo gestazione. PerchÃ© accanirsi contro la normalitÃ ,  fare esperimenti grotteschi e pericolosi,  giocare con la vita di quelli che potrebbero essere bambini e soffriranno rendendosi conto di essere figli di gente deviata ğŸ’”ğŸ˜¢ğŸ˜ˆ