GRUPPO
Ugo Fuoco ğŸ”¥ Stop Dittatura

DATA
18/07/2023

POST
ğŸ”´ğŸ’£TRANS STRACCIA RECORD ITALIANO PARALIMPICO FEMMINILE

ğŸ”¥Valentina Petrillo, nata Fabrizio Petrillo, ha stracciato il record italiano nei 200 metri femminili per i diversamente abili all'etÃ  di 48 anni.

ğŸ”ºï¸Come tutti sanno sono contro ogni forma di discriminazione, da sempre, ma sono anche dotato di un cervello e quindi mi faccio domande.

âš¡ï¸Come mai non si sente parlare di atleti trans nati donna gareggiare in competizioni maschili e, soprattutto, stracciarne i record?

ğŸ´â€â˜ ï¸Come mai una persona nata uomo, che nello sport ha sempre ottenuto pessimi risultati nelle competizioni maschili, gareggia in una competizione femminile per diversamente abili (dichiarando di non vederci bene) alla veneranda etÃ  di 48 anni (non propriamente l'etÃ  di un atleta da gara) riuscendo non soltanto a vincere ma anche a demolire tutti i record?

ğŸ”¹ï¸Mi faccio domande...ed ho delle risposte. Questa ipocrisia, che di fatto discrimina donne e persone diversamente abili, deve terminare subito.

COMMENTI
SenderA	Questo Ã¨ il nuovo mondo che ci aspetta....
SenderB	Anche categoria disabili? Nobel per la faccia da culo!
SenderC	Ahhhh idiozie ogni gg go na cretinata
SenderD	Uno schifo altro non si puÃ² dire  che vada a correre con i Trans ğŸ¤®
SenderE	Se succedono queste cose Ã¨ perchÃ© babilonia sta arrivando alla fine dei suoi tempi
SenderF	Cosa sono stato multato per aver detto che schifo?
SenderG	@SenderF Se qualcuno ti avesse mutato come staresti parlando ancora in chat?
SenderF	Infatti
SenderH	Ma va,una lotta e gara impari,tutte le donne dovrebbero ribellarsi e boicottare la manifestazioneâ€¦.la forza di un uomo non Ã¨ paragonabile a quella di una donnaâ€¦
SenderI	Merda vivente...bruciate all'inferno
SenderL	Un intelligente presto umiliera un idiota...la strada Ã¨ questa!
SenderF	PerÃ² mi Ã¨ apparso una cosa del genere non me lo sto inventando Ugo fuoco
SenderG	@SenderF Appare a tutti quelli che scrivono per la prima volta. Ãˆ il bot che gestisce la chat.
SenderF	Ha  ok infatti era la prima volta che scrivevo qualcosa ğŸ˜
SenderM	0iace vincere facile? Vigliacchi!!!
SenderN	Frocione mi fai schifo
SenderF	ğŸ¤£ğŸ¤£ğŸ¤£ğŸ¤£ğŸ¤£ğŸ¤£
SenderO	Ma c'Ã¨ l'avrÃ  ancora il pisello?
SenderF	Comunque e uno schifo stravolgere la natura umana non si tratta di razzismo ma c'Ã¨ l uomo poi la donna .
SenderP	Adesso sono loro che  discriminano
SenderF	@SenderO ğŸ˜‚ğŸ˜‚ğŸ˜‚ğŸ˜‚
SenderQ	Donne Boicottate in massa queste pagliacciate
SenderF	Viva le  patate ma non quelle di Bill Gates ğŸ¤£ğŸ¤£ğŸ¤£ğŸ¤£ğŸ¤£ğŸ¤£
SenderR	Questo Ã¨ il potere delle istituzioni e anche nellâ€™ultimo caso accaduto in un tribunale il potere della magistraturaâ€¦ il poter decidere che una persona Ã¨ di sesso opposto alla sua naturale nascita
SenderF	Donna meravigliosa 
SenderF	Infatti @SenderR ğŸ‘ maledetti
SenderS	@SenderF parli sul serio ? o volevi dire "la donna" come genere femminile ?
SenderT	Gli piace vincere facile ğŸ’©
SenderF	Infatti @SenderS ma non quel frocione ğŸ¤£ğŸ¤£ğŸ¤£ğŸ¤£ğŸ¤£
SenderU	Sono ridicoli....lei o lui che sia e anche la federazione.....pagliacci ğŸ¤¡ğŸ¤¡ğŸ¤¡ğŸ¤¡
SenderV	Na le donne dormono, dovrebbe rifiutarsi tutte di gareggiare
SenderZ	@SenderV Infatti ğŸ‘
SenderF	Esatto
SenderAA	@SenderU Che schifo ğŸ¤£ğŸ¤£ğŸ¤£ una lumaca ermafrodite
SenderV	@SenderZ Si vede a vista d occhio che non Ã¨ una  donna.
SenderF	Il problema e la propaganda frociona  di questi sattanisti schifosi
SenderAB	Ma le DONNE che dicono?
SenderAC	Nn si puÃ² sentire che un uomo perchÃ© uomo Ã¨ gareggi con la categoria delle donne rimane una gara impari e le atlete donne dovrebbero reclamare
SenderAD	@SenderAB Molte sono solidali nei loro confronti e cosi poi stravolgono l umanita ğŸ¤®ğŸ¤®ğŸ¤®
SenderAE	La sua disabilita'...
SenderAF	Infatti le Donne che diventano  pseudo Uomini, sono per forza dopate di testosterone, e quindi con chi gareggiano? Ecco il problema. Mentre un atleta da Uomo a Donna, mantiene intatto il suo cromosoma y,  che ovviamente dalla nascita ha favorito lo sviluppo muscolo scheletrico. Quindi a ben vedere si potrebbe parlare di "Doping Cromosomico". L assurdo Ã¨ che strombazzando la Gender per logica dovrebbero giustamente fare le gare Gender , Ã¨ ovvio. Invece parlano di una multiplicita', di genere, ma poi comprimono il discorso in una forma binaria Uomo-Donna. Il chÃ© rappresenta una contraddizione( perchÃ© ammetti l esistenza di due sessi principali). Inoltre esistono casi genetici di Pseudo Ermafroditismo vero. Seppur minimali , le uniche vere persone Gender Naturali, altro che siliconi e steroidi/estrogeni.
SenderAG	Ma a sto punto se la giocassero alla pari. 100 mt categoria trans!!!
SenderAH	Poteva fare anche il salto con lâ€™asta..lâ€™attrezzo non gli sarebbe mancato! ğŸ˜‚ğŸ˜‚
SenderAI	E una donuom ha.il pisello ma gode con il derettano
SenderAL	LE DONNE DEVONO RIFIUTARSI DI GAREGGIARE COI TRANS                     oramai si sa come va a finire! CHIEDERE DI CREARE LA CATEGORIA TRANS E FARLI GAREGGIARE TRA DI LORO
SenderAM	@SenderA Parla per te ğŸ˜‚ğŸ˜‚ğŸ˜‚ Scusa volevo solo fare una battutağŸ˜‰ Comunque non ho piÃ¹ intenzione da farmi influenzare da sta gente io mi faccio la mia vita e che si fottano! Ignoriamoli e ribelliamoci altrimenti sÃ¬, finirÃ  come dici tu. Quello comunque Ã¨ un fallito che ha provato a vincere facile
SenderAN	Faccia come il culo!!!!!
SenderAO	Tram
SenderAP	Grazie al cavolo. Ha corpo e muscoli da uomo.
SenderAQ	Le competizioni devono essere alla pari..come se una donna pesi piuma nella kickboxing facesse un incontro con un uomo di pesi mediomassimi,questi mezzi incroci,se le facciano tra di loro le gare,punto â˜ï¸
SenderAR	Un record che durerÃ  a lungo fino a chÃ© un'altro trans lo batterÃ ... Addio record di donne vere
SenderAS	Lo fare correre sui carboni ardenti con le mani, vediamo se fa il grosso
SenderAU	ğŸ¤£ğŸ¤£Tyson con la parrucca mi fa morireğŸ¤£ğŸ¤£
SenderAV	Bella forza c'ha tre gambe
SenderAZ	Michelle Tyson ğŸ¤£ğŸ¤£ğŸ¤£
SenderBA	Atlete donna???? Ãˆ ora di tirare fuori gli attributi!!!!
SenderBB	Vista la "nuova normalitÃ " propongo di fare partecipare agli incontri di box i gorilla e a quelli di mma gli orsi. Ma potremmo pensare anche ai ghepardi ai 100 mt, i canguri nel salto in lungo,... e cosÃ¬ via ğŸ˜‚
SenderBC	Chiaro. CiÃ² che vogliono Ã¨ una guerra tra le persone "arcobaleno" e i cattivi eterosessuali. Senza pensare che se non ci fossero gli eterosessuali nÃ© loro nÃ© le loro fidanzate/i esisterebbero. Difendiamo le famiglie!!!
SenderBD	Grazie al cazzo ğŸ¤£
SenderBE	@SenderBD Dici? AvrÃ  fatto qualche passo in piÃ¹ anche con quello? ğŸ˜‚
SenderBF	Tutti sono bravi a dire di essere donna e gareggiare cosÃ¬, vorrei vedere che caos che ci sarebbe ğŸ˜
SenderBG	Vorrei vedere le analisi ormonali di questa atleta... giusto per avere chiaro il quadro...
SenderBH	Che schifo
SenderBI	Beh normale ha il peperoncino ğŸŒ¶ dietro ğŸ¤·â€â™‚
SenderBL	Ahahahah....Madonna mia, ste notizie mi fanno schiacciare! Oh ma se lui si sente donna e disabile chi siete voi x negarlo!??ğŸ˜‚...io mi sento vecchio e invalido ok!? Ora voglio la pensione di vecchiaia, quella di invaliditÃ  e di accompagnamento!! E che cazzo! ğŸ¤·ğŸ»â€â™‚
SenderBM	Ma perchÃ© non li fanno gareggiare tra loro?a questo punto ci sarebbe paritÃ  di forza,mi dispiace che ancora le atlete donne non si siano fermate x protestare
SenderBN	MammÃ  mia roba da pazzi veramente
SenderBO	Fatelo correre da.solo a Valentina sto cazzo
SenderBP	Tra Ucraina e Russia Ã¨ in atto uno scontro di civiltÃ . Allora io dico anzi grido  MEGLIO RUSSO CHE CULATTONE
SenderBQ	Faccio un esempio: Ã¨ come se PelÃ© o Maradona ( rip tutti e due) facessero una gara di gol con un paralitico. Non c'Ã¨ limite alla vergogna.
SenderBR	Donne quando vedete una donna cazzuta che gareggia andatevene Dissenso assoluto Bisogna farglielo capire
SenderBS	Dovrebbero rifiutarsi di gareggiare con uomini travestiti e tutto finirebbe
SenderBT	@SenderH perfettamente d'accordo
SenderBU	@SenderAL esatto
SenderBV	e magari Ã¨ pure convintA di meritarsela la vittoria, di essere una campioneSSA. ğŸ¤¦ğŸ»â€â™‚ï¸ğŸ¤¬
SenderBC	Bene. Ci hanno dato uno spunto ottimo. Alla prossima imposizione di vaccino dichiariamo che ci sentiamo completamente e permanentemente immuni al covid e ad ogni e qualsiasi virus, costantemente e permanentemente. E mi sembra ingiusto che suppongono che non lo siamo visto che siamo immuni. Maledetti. Suppongano O meglio: siamo immuni perchÃ© ci sentiamo immuni.
SenderBZ	Ma le altre atlete donne dove sono? XkÃ¨ nn reclamano, dovr a gareggiare con gli uomini!!
SenderCA	A questo punto eliminerei proprio le gare "femminili"... non ha piÃ¹ senso. Mi piacerebbe sentire il parere dei medici dello sport sull'argomento.
SenderBC	@SenderBZ PerchÃ© finirebbe la loro carriera. Verrebbero oltretutto usate come capro espiatorio.
SenderCB	ovviamente queste prestazioni non devono essere registrate nella categoria femminile
SenderCC	Concordo.
SenderCD	mah... Ã¨ andata cosÃ¬ ğŸ¤·ğŸ»â€â™€ï¸ğŸ˜Š
SenderCE	To piace vincere facile?
SenderCF	Froci italiani... diranno all'estero.... Ãˆ fanno bene.!
SenderCG	Si puÃ² dire grazie al cazzo?
SenderCH	@SenderCG Sto giro siâ€¦ câ€™entra tutto ğŸ˜‚ğŸ¤£
SenderCI	si rifiutassero di gareggiare tutte
SenderCL	Hanno esattamente rotto le palle,  perchÃ©  non si fanno le loro competizioni da trans invece di rompere il cazzo e a discriminare le donne. O anche nei concorsi di bellezza....   fanno miss olanda un trans,   vergognatevi tutti quelli che appoggiano  questo. Fatevi il concorso di bellezza per voi   e fateci guardare le vere miss   la vera bellezza femminile     aria
SenderCD	@SenderCL ma lo fanno apposta per seminare confusione nelle coscienze (soprattutto dei bambini e adolescenti, che non hanno ancora punti fermi) e per sabotare l'ordine divino nella creazione e nella naturale differenza e complementare di uomo e donna. Il guaio Ã¨ che spacciano questa devastazione per "affermazione di paritÃ  di diritti o di pari opportunitÃ "... e i gonzi abboccano
SenderCM	Le donne donne fanno uno sport amatoriale per mantenersi donna , non fanno sport competitivi , e aggiungo non indossano nessuna divisa â€¦. Le vere donne ğŸ‘ğŸ‘Œ
SenderCN	Dove sono le femministe? Dove sono tutti quelli che si battono per l'uguaglianza? il mondo cosÃ¬ come sta diventando vi piace?
SenderCO	Ma le famose femministe dove minchia sono????
SenderBC	@SenderCO Se molte donne fossero intelligenti il femminismo non esisterebbe.  Mi sembra chiaro che queste donnette, che odiano le donne vere,  soffrano di gravi disturbi cognitivi. I conti non tornano, ma per loro Ã¨ tutto normale e giusto. Stanno insultando e umiliando gli uomini perchÃ© odiano il genere umano! Odiano sÃ© stesse, le donne e gli uomini!!! Sono sociopatiche... Anzi...psicopatiche pericolose!
SenderCP	@SenderBC Mi sembrano ragionamenti che si facevano negli anni 70 . Dualismo destra vs sinistra
SenderCQ	Non solo deve terminare subito, in veritÃ , non avrebbe mai dovuto esistereâ€¦
SenderCR	io ho vinto il torneo di pin pong dei simpson ..!!
SenderCS	Il femminismo fu finanziato dai Rockefeller per due principali motivi: tassare cosÃ¬ facendo il 100% della popolazione e far si che i figli dovessero andare a scuola ancor prima. Inserendoli nel circuito dellâ€™indottrinamento fin da subito. Sostituendo il concetto di famiglia a quello di Stato. Stesso principio applicato per quanto riguarda la propaganda LGBT: controllo e depopolamento. Tanto sempre li i arriva.
SenderCT	Tanto vale che giochi da solo. Chi vuoi prendere per il cul0??
SenderBC	@SenderCP Io sono una donna e sto descrivendo la realtÃ  dei fatti. Avvisare che ipoteticamente c'Ã¨ uno psicopatico nel paese che sta uccidendo gli uomini non Ã¨ mettere l'uno contro l'altro . Questo Ã¨ ciÃ² che stanno facendo e chiunque lo puÃ² vedere... @SenderCS Esattamente! In piÃ¹ avevano il vantaggio di indottrinare meglio i figli perchÃ© le mamme erano assenti per lavorare
SenderCP	@SenderBC Sara che in quanto anarchico non mi piace nessun vincolo sia da parte del femminismo che da parte della religione . Poi fate quello che volete
SenderBC	@SenderCP Nessuna religione e nessuna politica. Sto parlando di rispetto ed intelligenza. Mi spiego meglio... Non ho fatto nessun riferimento alla politica o alla religione. Si tratta semplicemente di intelligenza e buon senso. Ãˆ chiaro che chiunque voglia difendere i suoi diritti debba prendere dei provvedimenti per difendersi giusto?  Difendersi Ã¨ un ragionamento anni 70?
SenderCP	@SenderBC Infatti secondo molti l'Italia e il paese dei mammoni Perche le famiglie invece non influenzano? Ora io non voglio difendere la lobby gay anche se ho conosciuto alcuni omosessuali tra l'altro bravissimi pero scusate la gerarchia famigliare e meglio? Non mi sembra. L'Italia e piena di mammoni insicuri e pieni di fobie
SenderBC	Parlo di rispetto reciproco! Io non sono una nullitÃ  perchÃ© ho una famiglia. CosÃ¬ come un hay ha tutto il diritto di amare un uomo! Parlo di rispetto!
SenderCU	Ma non si vergogna per niente ğŸ¤®
SenderCP	@SenderBC Guarda l'importante e non sottomettere e ovviamente vale anche per loro
SenderCV	RIDICOLO!!!!ğŸ˜¡
SenderCZ	Lo facevo gareggiare solo se si evirava come in cappone.
SenderBC	@SenderCU No anzi! Poi si suicida perchÃ© ha capito di aver sbagliato a evirarsi! Povero mondo!
SenderDA	Ebbravo Valentone. Ti piace vincere facile?
SenderDB	Se era uomo doveva gareggiare con uomini, chissenefrega che ora Ã¨ donna
SenderDC	Mi chiedo con che coraggio, vabbÃ¨...
SenderDD	Ti piace vincere facile
SenderDE	Ãˆ disabile alla testa di cazzo che Ã¨ diventata
SenderDF	Se siamo arrivati a farci certe domande.... Ã¨ davvero giunto il momento nel quale dobbiamo sguainare la spada per affermare che l'erba Ã¨ verde.
SenderDG	Io mi chiedo dove sono le donne ...io mi sarei ritirata e avrei voluto si ritirassero anche le modelle in Olanda ...fuori il coraggio donne!!!!
SenderDH	PiÃ¹ che paraolimpica sembra proprio una paraculata
SenderDI	Assurdo e illogico... Ma che record Ã¨?....  Non c'Ã¨ piÃ¹ la vera competizione
SenderDL	Schifoso finocchio egoista e falso. E adesso denunciatemi  pure per omofobia. Nessuno politico vomita davanti a una merda del genere? Io sÃ¬.
SenderDM	La macchina dello spettacolo non sa piÃ¹ cosa inventare per aumentarsi i guadagni. Ãˆ la solita strategia della cosa strana che attira gli spettatori e la grana.
SenderDN	Increddibbileeee
SenderDO	SINCERAMENTE non capisco perche' LE DONNE  ( VERE NB)  GAREGGIANOâ€”- perdono i SOLDI degli SPONSOR?  io mi vergognerei...SCHERZIAMO?  e i mass media che intervistano sto qui !  BASTA. @SenderBD ESATTO ! nel senso  totale! il termine trans e' pero' fuorviante.... anche se glie lo hanno tagliato per me rimane e rimarra' sempre un TRAV